155s 1d
WWWWWWWWWWWWWW
WGGLGGG.GGDGPW
WGPRPGGGGGG.GW
WGGGGGGGGGG.GW
WPGPPGGLGGGGGW
WGG.PGGGGGGGGW
WGGG.GG.GGGGEW
WWWWWWWWWWWWWW
pseudo  =  00016750
pseudo  =  00016650
pseudo  =  00016650
00000000
default/map0.txt