150s 1d
WWWWWWWWWWWWWW
WGGGGGG.GGDGPW
WGPRPGGGGGG.GW
WGGGGGGGGGG.GW
WPGPPGGGGGGGGW
WGG.PGGGGGGGGW
WGGG.GG.GGGGEW
WWWWWWWWWWWWWW