150s 15d
WWWWWWWWWWWWWWWWWWWWWWWWWWWWWWWWWWWWWWW
WGGGGGG.GGDGP.GGGGPGPGGGGGGG.GGGGPGGGGW
WGPRPGGGGGGGGGGGGGGGPDGGPGGGG.GGGGG.GGW
WGGDGGGGGGGGGPGGGGGPGPGGPGGGGGGGGPGGGGW
WPGPPGGGGGGGGPGGLGGGPGGPGGGGPGGGPLGGGGW
WPG.PGLGGGGGG.PGGPGGGGGGGGPGGGGGGPGPPGW
WGGG.GGPGGGGGGGPGGGGGPG.PGGGGGGGGPGPPGW
WWWWWWWWWWWWWWWWWWWWWWWWWWWWWWGGGPGGPGW
WG.GGGPGGDG.GPGPGGGGGGGGGGDGPDGGGGGG.GW
WGGDGGLGGPGGGG.GGGGGGGGPP.PGGPGGGGPGGGW
WGPGPGGPGPGGGGGGLPPGGGGP.GPGGPGDGGGGPGW
WGDGG.GGPG..GGGGPGPDGDGGGGGPG.GPGLDG.GW
WG.PGGGGPGGGGGGGGP.PGPGGGGGGGGGDGGGGGPW
WGGGGGGGGWWWWWWWWWWWWWWWWWWWWWWWWWWWWWW
W.PGGGGGGGGPGGGDGGGPGGGGGPGGGPGGGGGGGGW
W.PGGGLGGGG.PGGPGGGGGGGPGGGGGGPGGPPGGEW
WG.GGPGGGGGGGPGGGLPG..GGGGDGGGPGGPPGGGW
WGGGGPDGGPGGGGGGGPGGGGGPGPDGGGGGGGPGGGW
WGGG.GGPG.GPGPPGGGGGGGGPGPDGGLGGGG.GGPW
WGDGGGG.GGGG.GGGGGGGG.GPGGPGGGGPGGGGPGW
WWWWWWWWWWWWWWWWWWWWWWWWWWWWWWWWWWWWWWW
Uniffayyyyy  =  00032100
Uniiiique  =  00031350
pseudo  =  00031050
00000000
default/map2.txt
0