150s 1d
WWWWWWWWWWWWWW
WGGEGGG.GGDGPW
WGPRPGGGGGG.GW
WGGGGGGGGGG.GW
WPGPPGGGGGGGGW
WGG.PGGGGGGGGW
WGGG.GG.GGGGGW
WWWWWWWWWWWWWW