150s 1d
WWWWWWWWWWWWWW
WGGGGGG.GGDGPW
WGPRPGGGGGG.GW
WGGDGGGLGGG.GW
WPGPPGGGGGGGGW
WGG.PGGGGGGGGW
WGGG.GG.GGGGEW
WWWWWWWWWWWWWW
pseudoYEAH         = 00017300
pseudo  =  00017300
pseudo  =  00017200
00000000
map1.txt
0