150s 15d
WWWWWWWWWWWWWWWWWWWWWWWWWWWWWWWWWWWWWWW
WGGGGGG.GGDGP.GGGGPGPGGGGGGG.GGGGPGGGGW
WGPRPGGGGGGGGGGGGGGGPDGGPGGGG.GGGGG.GGW
WGGGGGGLGGGGGPGGGGGPGPGGPGGGGGGGGPGGGGW
WPGPPGGGGGGGGPGGGGGGPGGPGGGGPGGGPGGGGGW
WPG.PGGGGGGGG.PGGPGGGGGGGGPLGGGGGPGPPGW
WGGG.GGPGGGGGGGPGGGGGPG.PGGGGGGGGPGPPGW
WWWWWWWWWWWWWWWWWWWWWWWWWWWWWWGGGPGGPGW
WG.GGGPGGDG.GPGPGGGGGGGGGGDGPDGGGGGG.GW
WGGDGGGGGPGGGG.GGGGGGGGPP.PGGPGLGGPGGGW
WGPGPGGPGPGGGGGGGPPGGGGP.GPGGPGDGGGGPGW
WGDGG.GGPG..GGGGPGPDGDGGGGGPG.GPGGDG.GW
WG.PGGLGPGGGGGGGGP.PGPGGGGGGGGGDGGGGGPW
WGGGGGGGGWWWWWWWWWWWWWWWWWWWWWWWWWWWWWW
W.PGGGGGGGGPGGGDGGGPGGGGGPGGGPGGGGGGGGW
W.PGGGGGGGG.PGGPGGGGGGGPGGGGGGPGGPPGGEW
WG.GGPGGGGGGGPGGGGPG..GGGGDGGGPGGPPGGGW
WGGGGPDGGPGGGLGGGPGGGGGPGPDGGGGGGGPGGGW
WGGG.GGPG.GPGPPGGGGGGGGPGPDGLGGGGG.GGPW
WGDGGGG.GGGG.GGGGGGGG.GPGGPGGGGPGGGGPGW
WWWWWWWWWWWWWWWWWWWWWWWWWWWWWWWWWWWWWWW
personne = 00000000
personne = 00000000
personne = 00000000
00000000
map3.txt
0