100s 30d
WWWWWWWWWWWWWWWWWWWWWWWWWWWWWWWWWWWWWWWW
WDGGGGGLWGLGGGGGGWGGGG.GGGGGGG.WWGGWGGGW
WGGLW.WGL.GGLGGPGG.GDGG.GP..G.GGGGGGGGGW
W.LGGG.GGGGGGGW.P.GGGGPDGGPGWWWWGLPGGGGW
WGLGWGGGGPGLWG.GGGGPGLGGPGGWGGGDGGGGPPGW
WGLGGGGGWDGGGDGGGWGGGPGGGGLGGPG.GRGGGPGW
WWPGGPGGGG..GGGLGGLWGGWLGG.WGGWGD..GGPGW
WGGGGD.LPP.GGLGGW.WGPPLPWGGWGPGGL.G..G.W
WDPGGPG.GLPPGGGGDDDGWDGGGGGGWGG.GDWGLLWW
WLGGGGLGGL.WGWGGGGGGG.LPLWGGGGGGGWWGGGWW
WGGGWPG.GGG.GGPGPGGGWGGGW.GGGGGGLPGGLG.W
WGGGGW.GLGLGPGGGGGDGWWPGWGGLGDWPGG.GGGGW
WGPGGWG.GPGGDGWG.GGPGGGWPDGGLGGGPGGGLGLW
WDGGGGLGGGGLGEGGWGLGG.G.GGDPLPGGDWGGGWGW
W.GGGGGLLLGG.LPPGGGGGGGGGGWW.PGGLGWGGGDW
W..GPGGGLGGGPPG.GGWGGGGLGLGGLGPGGGGGGGGW
WGWLGLPPGGGGGGGGGG.GLGGGPPGGGGGGGP.GGGGW
WGWGGGDPWG.GLDWGGGGGGGGGGDGPGGWDP.G.GGGW
WGGGGGGGGGWWGGPPGGGGP.PWPGPPGPGGGGL..GGW
WGGGLGLGDGGPDGGPGGPLGGGGGLGGGGGGGPGGGGDW
WGWGGGWGGGGGGGGPGLWGWDGGGDDWGGGLGDPGG.GW
WWWWWWWWWWWWWWWWWWWWWWWWWWWWWWWWWWWWWWWW
personne = 00000000
personne = 00000000
personne = 00000000
00000000
map4.txt
0
