100s 27d
WWWWWWWWWWWWWWWWWWWWWWWWWWWWWWWWWWWWWWWW
W.GWGGGP.GLWGGDGG.LGWPGGLGGG.WDGGGGGDWGW
WGGLGGGWGGGGGG.GDGGGGLGGPWLGGGDDGGLGGGWW
WGWGWPGGPPGGPGGLGGGDGGGGGGPGGGLLG.GGG..W
WGWGGDWPPGGGDGGW.PWPGGGGPWGG.GPG.GPG..GW
W.PLWGGG.GW.GWGLLGLGP.GPGGWGGGPGGGG.GGWW
WDGGGGGGPGGGGPGGGPGDGG.PGG.GGDGDGWGPW.GW
WGPLGGPGLLGP.GGDPWDGGGGGWDWGLGG.PGPGGGPW
WGPGPDGGWGGGPGD.GGLGDGPG.DWGLGLPGPG.GGWW
WGWGGGGGWGPGGGGLGGPWGPGGLLGGGGLGGD.GGWGW
WGWGGGDGGGWG.P.GGGGGGLW.GGGW.GGGWGWGGDPW
WGWGGGLLPDG.PGGL.GGPG.GGPGGPGLGGGPWGGLGW
WGGLGG.EGGGGWGGPLGGLGGP.GGGGGGLGGGLGPGPW
WLG.WLGGWL.GGLGP..GGGDLGGPWGGWWPGLDGD.PW
WPRGWGGGGGGGGGWLD.GGPDDGGLGW.GLGGPGGWGPW
WGGGPGPGGPGGGGGGG.LGG.GGGGPWGGGGGGGGPGGW
WGGGGPGLGLGGGGLG.GG.GGGGGWWGGGGGG.PGGGGW
WGGDPGG..PL.G..LGGGWGGG.PGPG...GGGDGGGGW
WGGGGGLWGGGGWG.GG.GG.GG.GGWGLGGGGLG.WPGW
WPPGGPGLGGPPGGGGLGGGLGGGWDGW.GGG.GDLGGGW
WGLPGWGGGGPGGGPGGG.W.GGG.PGGGGPGDGGGG.GW
WWWWWWWWWWWWWWWWWWWWWWWWWWWWWWWWWWWWWWWW
pseudo  =  00038350
personne = 00000000
personne = 00000000
00000000
map5.txt
0