100s 29d
WWWWWWWWWWWWWWWWWWWWWWWWWWWWWWWWWWWWWWWW
WGW.GWG.GGGP.GWPG.LGGG..GGGGPGGGGGGPGLGW
WGGDW.GGGWGGGG.GWPG.GLGGGGGGGGGGGGG.GGWW
WGGDGPLGGPDGGPGWGGGGWDDWGGDPDLGWGLGGPGGW
WGGGGDPPGLWPGWGGPGLGWPGGWPGGGP.D.LGGLWDW
WGW.GGDG.LDGGGG.WGPWWGGGGGPWGGG.LGGPGG.W
WWGGGPLPGGGLGGWGGLGLWGGP.DP.G.GGWGGGGGGW
WGDDGG.WGGGGG.WPGPG.GGGP.PGGGPGGGGGPGDPW
WLGPGWDWGLGDDGGGGGGGWG.GG.GWLW.L.GPWGPGW
WGPPPLGWGPGGGGGGGLG.G.GGGL.G.GGGGGGLGG.W
WLGPGPWPGGPDG.GLGGGWGWGGGDPGWGGGDGGGGWGW
W.GGGPGGWGWPPGGP.W.GGGGGGG..GGLGGGPWPGGW
WGGWG.GWPGWGGGG.GGG.GGPGGGPPGGW.GDGGGPGW
WG.GGDGGWGPGGGLWWGGGGGG.GGGGLGGWPGPPWGGW
W.GG.PGGG.LGPWGGGGGGGGGEGWGPGGGP.GGLGGGW
WWGGGGGGWLGGGGLGGWGWRLGGGGGDGG.WGGGGGGGW
WWPLGGG.LLGGG.GGWGGW..GPGGGGGLPGGWGGWGGW
WGPGGGGGGW.GPGG.GG.DWGGGGGGGGGGGGGGG.GGW
WGWPG.G.GDGWP.GGGWPDWGGGGLGLPPGGWGL.PDGW
W.GGPGGGGGGGGGG.GW.LW.GGGGLD.G.PLGGGL.PW
WGLW.WGGLGGGGLGLLLGGGGGG.GGWPGDG.LGGGGPW
WWWWWWWWWWWWWWWWWWWWWWWWWWWWWWWWWWWWWWWW
personne = 00000000
personne = 00000000
personne = 00000000
00000000
map6.txt
0
