100s 35d
WWWWWWWWWWWWWWWWWWWWWWWWWWWWWWWWWWWWWWWW
WGW.GGW.LGGGWGGGGGPGGGG.GLW.GGDGGWGG.L.W
WGG.LPLWGGGDGGGGGGGGGGGLGG.G.W.WDRG.WGDW
WPP.GGGGLGGGGPGLGWLDGGGGGPGPGDGG..GWGWLW
WGGGGGGLGDGGGDGGGGGWGGG.P.GG.GDDLGGGGG.W
WGGGGWGGGGGGDGGGGPGGGGGLGGGLGG.GW.PGGL.W
W.LLG.DWWGLGGWDLWGGGPGPGGGGGGG.LWGGGGWWW
W.W..GGDGGGGGWLG.GGPGGDDGW..GPGG.GGPGGGW
W.PGGGGGWP.G..DLP.G.GGGWGPGGPGGGGPPPGGDW
WPGG..GGGG.GGGLGWGGGGGLLWGPGGGGGGPG.GWWW
WPGPGG..GWGGDGWG.GGG..WWGWWPGGPGGGGGWGLW
W.W..GP..GGGGLPGGGGWPPGGG.LDGD.DGGGGDDGW
WGGWD.GGLPGGLWPLGGGGGGGGGGGGWWGGDPGGDGGW
WGDGWGGGGPDGPGGLWGGWGGDLGG.GGGPGPPLWGL.W
WDGGPGGGPGGLGGGDGG.GGGGG.DGGGGWGGGGG.GGW
WGWPGGG.GGGGGL.GPGG.GGGWGWP.GLGDGGGGG.GW
WPWGP.DLLGLGGGGGG.GGPGGGGGG..GGDGGWGGGGW
WGEGG.GPG.GGGGPDGGGGGGL.GGGWG.WGGGGGGPGW
WGPGWGG.GGGLG.LGGGLGGGGGG.GPG.GGPGGGGGPW
W.G.GGGWG.GGGGGG..WWGGGGGGGGLDWGGGGGGGGW
WDPGGPPWW.GG.G.DGP.GLWLGPWPGGGLGGGPPGGDW
WWWWWWWWWWWWWWWWWWWWWWWWWWWWWWWWWWWWWWWW
Kirby  =  00042200
personne = 00000000
personne = 00000000
00000000
map_aleatoire.txt
0