146s 1d
WWWWWWWWWWWWWW
W...GGG.GGDGPW
F.P.PGGGGGG.GW
WGGGGGGGGGG.GW
WPG..GGGGGGGGW
WGGPPGGGGGGGGW
WGGGPGG.GGGGEW
WWWWWWWWWWWWWW
personne = 00000000
personne = 00000000
personne = 00000000
00000000
