100s 37d
WWWWWWWWWWWWWWWWWWWWWWWWWWWWWWWWWWWWWWWW
WPGPGGGG.GGGWGWGDWDGG..D.WGGDGGGG.GWGGGW
WGPDGGPGGGDDGPP.GGPGGGG.GGGWGGG.GGGPPDGW
W.P.GPDPGGWP.PGGGGGDGPGPGGPGGG.GGGGWGGGW
WPGGGGPGGPGGG.PWG.G.PGGPWGGG.WWDGG.WGG.W
WW.GGGPGWGGGGGGGPGGPGGG.GPGGGWGG.WGGGGGW
WWGGGGGPWPG.PGGPWG.GWGGGWGGG.GGGGWDGGGGW
WWGWPGPPGGGGWGGGGGPWGDGGGWDWGGW.GG.GGWGW
WWGWGGGPPGPDPGGGGGWGGGGGGGGGGDGGD.P..GPW
WGWGWGG.WGGGGGPGGEGD.WGGG.G.GDGGGG.GGGDW
WPGG.GGGWWGGGGGGGGGGGGGGWGGGDPGPGPPWGDWW
W.GWGGGGGPP.WGGGWWG.GDGGGGWDGGPGGGGWGWPW
WGGGGDGPGGGWGGGDGGDWGGP.GGPGGDGGWWGGGGGW
WW.PGPGGGP.WGGGWGGGDWGGGDGGGGGGWGGGGGGPW
WW.GGGGGGGGGPGGGDPGPDGGDGDGGGG.GGGGPGGGW
WGGWGGGGWPGGPGGGGWGGDWGGG..GGGGPGGGGGGGW
WP.GGGGGG.G.W.GGGW.GWDGW.PGWGDGGG.GPGWGW
WGGGGGPGGWGWGGGGWGGWGPPPGGGGWWPDGGGGG.GW
WWGGGGGGGGGGW..GGGGGGGGGWPGWGG.PGGDWGGGW
WGWPGGG.PRWGGG.WGGGGGGG..GGGGGGWGWGGGGPW
W.GWGWGGGPGGGW.GGGGGPDGPGGGGGGDGGGGG.GGW
WWWWWWWWWWWWWWWWWWWWWWWWWWWWWWWWWWWWWWWW
personne = 00000000
personne = 00000000
personne = 00000000
00000000
map_aleatoire.txt
