100s 35d
WWWWWWWWWWWWWWWWWWWWWWWWWWWWWWWWWWWWWWWW
WGGGPPGGGGD.G.GGGGGGGPG.GGGGGGGLGGGGG.GW
WGL.PGGLGGGGLGLG.G.PGGGGPG.GPGGPG.GGDGGW
WGPGGGLG.GG.GGLGG.GGGGG.DGGGGDGGPGD.L.GW
WGGGPLGGGDGLGGGGGGGLGGGPGGPL.GGGGG.GLGGW
W.GPGGGG.GGPGGDG.LDP.LGGGGLGPGGGGGLGPGGW
WGPGGLG.GGGGGGGGGGGGGGP.GG.LGGGGPG.GGGGW
WGGGDLGPGGGGPGGGL.PGGGGDGGGLGPGGG.GLGGGW
WLLLGPGGGG.GGGGPGGP.GGGGGGGLGL...DGGGLDW
WLGGPGGGGPLPPPGGGLGPGGG.DGGGGDG.GLGPGGDW
WGPLGGGDGLGPLGGGLG..GLGGDGGGGGPPG..GGGGW
WGGPGGGGDGGGGGLGGGP.GPLDGPGGGGG.GGGGGGGW
W.LGG.GGGGLG.GGGGG.G.D.GGLPGGPDGGGGPGGGW
WPGPGLDGGGDLGGLLD..PGPGLPGPPGG.GPGGGPGGW
WGGDGPGGGPGGGGGPGGGGDGGGG.GGGGGLGGG..GPW
W.GGGGGPGLGPGDL.GLGG.GGLLGL.GDGDGGGGGGGW
WGGG.PGGGGGGGPLG.GGGGGGGPGGLP.GPGPGLLGGW
WG.GGPPLGG.GGDLDGEGGPGGPG.GGGLGGGGDGLGGW
WGGG.G.LLLG.GPGGGGGLGPGG.GGGGPGPPDGGDGLW
WGGGGGGDGGGGDG.GGGRGLGGG.L.GGGPGPGLL..LW
WLGGPGGLLGGLGGGGPGDGGGGLG.G.GGG.LGGLGDGW
WWWWWWWWWWWWWWWWWWWWWWWWWWWWWWWWWWWWWWWW
personne = 00000000
personne = 00000000
personne = 00000000
00000000
map_aleatoire.txt
