146s 1d
WWWWWWWWWWWWWW
WGGGGGG.GGDGPW
FGP..GGGGGG.GW
WGG..RGGGGG.GW
WPG.PGGGGGGGGW
WGGPPGGGGGGGGW
WGGGPGG.GGGGEW
WWWWWWWWWWWWWW
personne = 00000000
personne = 00000000
personne = 00000000
00000000
