144s 1d
WWWWWWWWWWWWWW
WGGGGGG.GGDGPW
FGP.PGGGGGG.GW
WGG.GGGGGGG.GW
WPGR.GGGGGGGGW
WGGPPGGGGGGGGW
WGGGPGG.GGGGEW
WWWWWWWWWWWWWW
personne = 00000000
personne = 00000000
personne = 00000000
00000000
