136s 0d
WWWWWWWWWWWWWW
WGGGGGG...RGPW
FGP.PGG.GGG.GW
WGG.GGG.GGG.GW
WPG.....GGGGGW
WGGPPGGGGGGGGW
WGGGPGG.GGGGEW
WWWWWWWWWWWWWW
personne = 00000000
personne = 00000000
personne = 00000000
00000350
