98s 30d
WWWWWWWWWWWWWWWWWWWWWWWWWWWWWWWWWWWWWWWW
WDGGGGGLWGLGGGGGGWGGGG.GGGGGGG.WWGGWGGGW
FGGLW.WGL.GGLGG.GG.GDGG.GP..G.GGGGGGGGGW
W.LGGG.GGGGGGGWPP.GGGGPDGGPGWWWWGLPGGGGW
WGLGWGGGGPGLWG.GGGGPGLGGPGGWGGG.GGGGPPGW
WGLGGGGGWDGGGDGGGWGGGPGGGGLGGPGDGRGGGPGW
WWPGGPGGGG..GGGLGGLWGGWLGG.WGGWGD..GGPGW
WGGGGD.LPP.GGLGGW.WGP.LPWGGWGPGGL.G..G.W
WDPGGPG.GL.PGGGGDDDGWPGGGGGGWGG.GDWGLLWW
WLGGGGLGGLPWGWGGGGGGGDLPLWGGGGGGGWWGGGWW
WGGGWPG.GGG.GGPGPGGGWGGGW.GGGGGGLPGGLG.W
WGGGGW.GLGLGPGGGGGDGWWPGWGGLGDWPGG.GGGGW
WGPGGWG.GPGGDGWG.GGPGGGWPDGGLGGGPGGGLGLW
W.GGGGLGGGGLGEGGWGLGG.G.GGDPLPGGDWGGGWGW
W.GGGGGLLLGG.LP.GGGGGGGGGGWW.PGGLGWGGGDW
WD.GPGGGLGGGPPGPGGWGGGGLGLGGLGPGGGGGGGGW
WGWLGLPPGGGGGGGGGG.GLGGGPPGGGGGGG..GGGGW
WGWGGGDPWG.GLDWGGGGGGGGGGDGPGGWDPPG.GGGW
WGGGGGGGGGWWGGPPGGGGP.PWPGPPGPGGGGL..GGW
WGGGLGLGDGGPDGGPGGPLGGGGGLGGGGGGGPGGGGDW
WGWGGGWGGGGGGGGPGLWGWDGGGDDWGGGLGDPGG.GW
WWWWWWWWWWWWWWWWWWWWWWWWWWWWWWWWWWWWWWWW
personne = 00000000
personne = 00000000
personne = 00000000
00000000
map_aleatoire.txt
2.4131293296813965
