100s 29d
WWWWWWWWWWWWWWWWWWWWWWWWWWWWWWWWWWWWWWWW
WGGDGGWGGW.GGGGGGGPPGPGPGGGGWGGPGGGGGGWW
WPGWDG.GGGGGWGGGGGGPGGDGLGGGGRG..GGGWGPW
WGGGGGPGGPGWGGGPGGGG.GG.GWGGW.WGPGGGPP.W
W.GGGGGLGGGGGGGG.GGGGGG.GGGGGG.GGGGGGG.W
WLGLGGGGG.GGGGPPGWGGPGD.DGGGPGGGWP.GDGWW
WP.GGGGG..GG.PWGPG.PPL.GGGG.GDGGG.GGGGGW
WDGPGG.GG.GGG.GGDGGDG.G.PGWGGWGGGGGGGGGW
WGGGGWGGGGD.PGGGGPGGGEGGGGGGG..DG..LGG.W
WGGWGGGG....GGGGGLDGGGGGWGLGDGGGP.GP.G.W
WGGWGGGGPPGP.PGGGDGGGGGGGGGW.WGWGGGGPGGW
WWPPDGGPGPGDPGGWG..GP.GPGGGGGG.GGGGPWGGW
WGGGG.WG.PGGGGPGG.GGGWGGWGDGGGGGG.GG..GW
W..WGGGWGGGG.GGG.GDGDWGWGGGGWGWG..GWGGGW
W.GWP..PGGGG.WGPGWGGWGGGGGGGGGG.GPGGPGWW
WGGPG.GWGGGGWG.GPDPGGGGGGGGGGGGG.G.G.PWW
WPPGD.GGG.GPGGPP.GWGGGG.GGGWGGGGPGGPWGGW
WG.GGPGGGGGGGGGD...GWP.GWPG..GGGGGGGGGGW
WGGDGWGDDGGWGPGPPGGGDGGGGGPGGGL.PGGGGGGW
WPGGGPW.PG.GGPGGGGGW.GG.G.GG.GGGGGGWGDGW
WGGGGGGGGGGGWGPGDGGGDGGGGLG.GDGGGGGG.WGW
WWWWWWWWWWWWWWWWWWWWWWWWWWWWWWWWWWWWWWWW
personne = 00000000
personne = 00000000
personne = 00000000
00000000
map_aleatoire.txt
0
