153s 0d
WWWWWWWWWWWWWW
WGG.....GG..PW
FGP.PG......GW
WGGGGGGGGG..GW
WPG..GGGGG...W
WGGPPGGGGGGGRW
WGGGPGG.GGGGEW
WWWWWWWWWWWWWW
personne = 00000000
personne = 00000000
personne = 00000000
00000350
