150s 18d
WWWWWWWWWWWWWWWWW
WPGPGWGGGGGGGGGGW
WGGGDWGGWGG.GGGDW
WL.GPW.PG.G.GDDGW
WPGGLW.WPGG.GDDGW
W.GGDWPGWGPGPGDGW
WGGGGWWG.GGGGGWGW
W.PGLWGGG.PGGGGGW
WGWG.W.GGDWGWWWWW
W.GGGWG.DWGGWGLWW
WGGGPWGDWGGWWDGWW
W.GGPWDWGGGPGGGWW
WGGGPWWDDGPDGLGWW
WLGGGGGGGGPLGGGWW
WDDDDPGLDGGGLGGWW
WREWPPGGGGGGGGGWW
WWWWWWWWWWWWWWWWW
personne = 00000000
personne = 00000000
personne = 00000000
00000000
omg.txt
0