60s 5d
.....................
.....WWWWWWWWWWW.....
.....WPGGGGGGGPW.....
.....WGGPPGDGPGW.....
.....WGRGDGGGGGW.....
.....WGGGGGPGGGW.....
.....WPGPGGGGGPW.....
.....WGGGGPGGGGW.....
.....WGPGGGGPGGW.....
.....WGGPGGGDPGW.....
.....WGGGGPGPGPW.....
.....WWWGGDPGGGW.....
.......WPGPGGPGW.....
.......WDGPDPGEW.....
.......WWWWWWWWW.....
.....................
.....................
.....................
.....................
.....................
